R    1200     800
NO     ./textures/bricks.xpm
SO ./textures/woolsnow.xpm
WE ./textures/sand.xpm
EA ./textures/glass.xpm
S ./textures/barrel.xpm
F       220   ,     151  ,    255
C 80,80,80

11111111111111111111111111111111
10000002222222222222222222222221
10000002222222222222222222222221
10000W02222222222222222222222221
10000000022222222222222222222221
10000002222222222222222222222221
10000000000000000000000000000001
10000000000000000000000000100001
10000000000000001001000000010001
10020200000100000100101000000001
10020000001000000000000001000001
10000000100000000000000000100001
10000001000100000000000000010001
10000000100001000000000010000001
10000000100001000000000001000001
10000010100001000000000000000001
10000000111111000000000000000001
10000000210000000000000000000001
10000000000000000000000000000001
10000000000000000000000000000001
10000000000000000000000000000011
1111111111111111111111111111111