R 1920 1080
NO ./path_to_the_north_texture
SO ./path_to_the_south_texture
WE ./path_to_the_west_texture
EA ./path_to_the_east_texture
S ./path_to_the_sprite_texture
F 220,100,0
C 225,30,0
        1111111111111111111111111
        1000000000110000000000001
        1001000001110000002000001
        1001000000000000000000001
111111111001000001110000000000001
110000000000100000111111111111111
110000000000011111
110001111111110111
11000111111111011111111111111
10000001101010000000000000001
10002000000000000000000000001
10000000000000000000000000001
11000000000000000000011110N01
11110000111000000001111000001
11111111111111111111111111111