R 1920 1080
NO ./path_to_the_north_texture
SO ./path_to_the_south_texture
WE ./path_to_the_west_texture
EA ./path_to_the_east_texture
S ./path_to_the_sprite_texture
F 220,100,0
C 225,30,0

11111111111111111111111111111111
10000000000000000000000000000001
10000000000000000000000000000001
10000000000000000000000000100001
10000000000000101001000000010001
10000000000101000100101000000001
10000000001000000000000001000001
100000001000000N0000000000100001
10000001000100000000000000010001
10000000001010000000000010000001
10000000100000000000000001000001
10000010000000000010001000000001
10000000100000000100010000000001
10000000010010000000000000000001
10000000000001000000000000000001
10000000000000000000000000000001
10000000000000000000000000000001
11111111111111111111111111111111