R 1500 1500
NO ./textures/bricks.xpm
SO ./textures/woolsnow.xpm
WE ./textures/sand.xpm
EA  ./textures/glass.xpm
S ./textures/barrel.xpm
F 0, 191, 255
C 152, 191,

11111111111111111111111111111111
10000000000000000000000000100001
10000000000000000000000000100001
1                    S    0    1
12222222222222222222202222222221
12222222222222222222202222222221
12222222222222222222202222222221
12222222222222222222202222222221
12222222222222222222202222222221
12222222222222222222202222222221
12222222222222222222202222222221
12222222222222222222202222222221
12222222222222222222202222222221
12222222222222222222202222222221
12222222222222222222202222222221
12222222222222222222202222222221
12222222222222222222202222222221
12222222222222222222202222222221
12222222222222222222202222222221
12222222222222222222202222222221
12222222222222222222202222222221
12222222222222222222202222222221
12222222222222222222202222222221
12222222222222222222202222222221
10000000000000000000020000100001
10000000002220000000000000000001
10000000000000000000000000100001
10000000000000001001000000010001
10000000000100000100101000000001
10000000001000000000000001000001
10000000100000000000000000100001
10000001000100000000000000010001
10000000100001000000000010000001
10000000100001000000000001000001
10000010100001000000000000000001
10000000111111000000000000000001
10000000000000000000000000000001
10000000000000000000000000000001
10000000000000000000000000000001
10000000000000000000000000000001
1111111111111111111111111111111