R 1500 1500
NO ./textures/bricks.xpm
SO ./textures/woolsnow.xpm
WE ./textures/sand.xpm
EA  ./textures/glass.xpm
S ./textures/barrel.xpm
F  10 ,0, 85
C 152,191, 15

     1111111111111111111111
1111110000000000000000000001
1000000000000000000000000011111
11000000000000000000000000000N01
10000000000000000000020000100001
11100000002220000000000000000001
100000000011100000000000000100001
1000000001  100001001000000010001
10000000001110000100101000000001
10000000001000000000000001000001
10000000100000000000000000100001
10000001000100000000000000010001
10000000100001000000000010000001
10000000100001000000000001000001
10000010100001000000000000000001
10000000111111000000000000000001
10000000000000000000000000000001
10000000000000000000000001111111
11111000000000000000000001
    1000000000000000000001   111
    1111111111111111111111   10111
    1111111111111111111111    11
      111