R 1200 900
NO ./textures/bricks.xpm
SO ./textures/woolsnow.xpm
WE ./textures/sand.xpm
EA ./textures/glass.xpm
S ./textures/barrel.xpm
F 220,100,0
C 225,30,0

11111111111111111111111111111111
10000002222222222222222222222221
10000002222222222222222222222221
100E0002222222222222222222222221
10000002222222222222222222222221
10000002222222222222222222222221
10000000000000000000000000000001
10000000000000000000000000100001
10000000000000001001000000010001
10020200000100000100101000000001
10020000001000000000000001000001
10000000100000000000000000100001
10000001000100000000000000010001
10000000100001000000000010000001
10000000100001000000000001000001
10000010100001000000000000000001
10000000111111000000000000000001
10000000210000000000000000000001
10000000000000000000000000000001
10000000000000000000000000000001
10000000000000000000000000000001
11111111111111111111111111111111