R 1500 1700
NO ./textures/bricks.xpm
SO ./textures/woolsnow.xpm
WE ./textures/sand.xpm
EA  ./textures/glass.xpm
S ./textures/barrel.xpm
F  10 ,0, 85
C 152,191, 15

     1111111111111111111111
111111000000000000000000001
1000000000000000000000000111111
11000000000000000000000000000N01
10000000000000000000020000100001
11100000002220000000000000000001
100000000000000000000000000100001
100000000000000001001000000010001
100000000111100000100101000000001
100000000010000000000000001000001
111111111111111111111111111111111